####################
#..................#
#..@...........h..#
#..................#
#....||||||........#
#..................#
#..............>...#
####################
