########################
#......................#
#..@.......!...........#
#......................#
#....||||..............#
#..~~..........F.......#
#......................#
#......D...............#
#......................#
#.h.......t...|||......#
#......................#
#..................>...#
########################
ROUTE 0 15,5 16,5 17,5 18,5 19,5 18,5 17,5 16,5 15,5 14,5
