####################
#..................#
#..@.....x.....h..#
#..................#
#....||||..........#
#..........F.......#
#...x..............#
#..............>...#
#..................#
####################
ROUTE 0 11,5 12,5 13,5 14,5 15,5 14,5 13,5 12,5 11,5 10,5
