####################
#..................#
#..@...........h...#
#..................#
#....||||||........#
#..................#
#..............>...#
####################
